W/W/W/W/W/W/W/W/W/W/W/W/W/W
W/X/X/O/O/L/X/O/O/O/O/X/X/W
W/O/O/O/O/O/X/O/O/O/O/O/O/W
W/O/O/O/O/O/B/O/O/O/O/O/O/W
W/P/O/O/O/O/X/O/O/O/O/O/O/W
W/X/X/O/O/L/X/O/O/O/O/X/X/W
W/W/W/W/W/W/W/W/W/W/W/W/W/W